1111111111111111111
1000202020202020201
1212121212121212101
1020202020202020201
1212121212121212121
1020202020202020201
1212121212121212121
1020202020202020201
1012121212121212121
1020202020202020001
1111111111111111111
