11111111111111111111111111111111111111111111111111
10000000000000000000000000000000000000000000000001
10212121212121212121212121212121212121212121212101
10121212121212121212121212121212121212121212121201
10000000000000000000000000000000000000000000000001
10220001111111111110000000220000001212121212100001
10220000000022000000000002200000001212000000000001
10220000000022000000000022000000001212000000000001
10220000000022000000000000000000001212121212100001
10220000000022000000000000000000000000000121200001
10220000000022000000000000000000000000000212100001
10220000000011000000000000000000001212121212100001
10000000000000000000000000000000000000000000000001
10212121212121212121212121212121212121212121212101
10000000000000000000000000000000000000000000000001
10012121212121121200000012000000120000120000012001
10012121221212121200000021000000210000212000021001
10012121200000000000000012000000120000120100012001
10012121200000000000000021000000210000212020021001
10012121221000000000000012000000120000120002012001
10012121212000000000000021000000210000212000221001
10012121200000000000000021000000210000212002021001
10012121200000000000000021121211210000212000121001
10000000000000000000000000000000000000000000000001
10212121212121212121212121212121212121212121212101
10121212121212121212121212121212121212121212121201
10000000000000000000000000000000000000000000000001
11111111111111111111111111111111111111111111111111
